30 40
0002 0006 0012 0010 0002 0006 0014 0012 0012 0010 0006 0012 0010 0006 0010 0006 0012 0012 0010 0006 0014 0012 0010 0004 0012 0012 0014 0010 0004 0010 
0003 0003 0002 0003 0003 0003 0003 0006 0012 0009 0003 0004 0015 0009 0005 0009 0006 0008 0003 0001 0005 0010 0005 0010 0006 0012 0009 0005 0012 0011 
0005 0009 0003 0003 0003 0003 0003 0003 0006 0010 0005 0010 0003 0006 0010 0002 0007 0012 0009 0006 0012 0009 0006 0009 0003 0004 0010 0006 0010 0003 
0006 0012 0013 0009 0005 0009 0003 0003 0003 0003 0006 0009 0001 0003 0003 0007 0009 0006 0012 0011 0002 0006 0009 0006 0009 0006 0009 0003 0003 0003 
0003 0006 0010 0006 0012 0012 0009 0005 0009 0003 0003 0006 0010 0003 0003 0005 0010 0007 0008 0003 0007 0009 0004 0011 0006 0009 0006 0009 0003 0003 
0005 0009 0003 0007 0012 0012 0012 0010 0006 0009 0007 0009 0005 0009 0003 0006 0009 0003 0006 0009 0003 0006 0012 0009 0007 0010 0005 0010 0005 0009 
0006 0008 0003 0003 0006 0010 0002 0003 0005 0010 0005 0012 0012 0008 0003 0005 0010 0003 0005 0010 0005 0009 0004 0014 0009 0007 0008 0003 0006 0008 
0007 0010 0003 0005 0011 0005 0009 0003 0006 0009 0006 0012 0012 0012 0009 0002 0003 0005 0010 0005 0012 0012 0010 0005 0008 0007 0012 0009 0005 0010 
0003 0003 0003 0002 0003 0006 0012 0009 0005 0012 0009 0002 0006 0014 0012 0009 0005 0010 0003 0004 0012 0010 0003 0006 0010 0005 0012 0010 0006 0011 
0003 0003 0003 0003 0003 0003 0004 0012 0014 0012 0012 0013 0009 0003 0006 0012 0010 0003 0005 0012 0012 0011 0005 0009 0003 0006 0010 0005 0009 0003 
0003 0005 0009 0007 0009 0003 0006 0010 0003 0004 0012 0014 0010 0005 0009 0002 0003 0005 0010 0006 0010 0003 0006 0010 0005 0009 0003 0006 0008 0003 
0003 0006 0012 0009 0002 0005 0009 0003 0003 0006 0012 0009 0003 0006 0014 0011 0005 0012 0009 0003 0005 0009 0001 0007 0012 0010 0003 0005 0014 0009 
0003 0003 0006 0010 0007 0010 0006 0009 0003 0003 0006 0010 0003 0003 0003 0003 0004 0014 0010 0005 0012 0012 0012 0009 0002 0003 0005 0010 0003 0002 
0003 0005 0009 0005 0009 0001 0003 0004 0013 0009 0003 0001 0003 0001 0003 0005 0012 0009 0003 0006 0012 0012 0012 0010 0003 0003 0002 0003 0003 0003 
0005 0012 0012 0012 0012 0010 0007 0010 0006 0008 0007 0010 0005 0012 0009 0002 0006 0010 0003 0003 0004 0012 0010 0003 0003 0003 0003 0003 0005 0011 
0006 0012 0012 0010 0006 0009 0003 0003 0005 0014 0009 0003 0006 0014 0012 0011 0003 0005 0009 0005 0010 0006 0009 0003 0003 0003 0003 0005 0010 0003 
0005 0012 0010 0005 0009 0006 0009 0005 0010 0005 0008 0005 0009 0007 0010 0003 0003 0002 0006 0014 0009 0003 0006 0009 0005 0013 0013 0010 0003 0001 
0006 0008 0005 0012 0010 0005 0012 0008 0005 0014 0012 0012 0010 0001 0003 0001 0003 0003 0003 0003 0006 0013 0009 0006 0012 0012 0010 0003 0005 0010 
0003 0006 0012 0010 0003 0006 0012 0012 0010 0005 0012 0010 0005 0010 0005 0014 0009 0005 0011 0003 0003 0006 0010 0003 0006 0008 0003 0003 0002 0003 
0007 0009 0002 0003 0003 0005 0010 0002 0005 0012 0010 0005 0008 0005 0010 0005 0012 0010 0001 0003 0003 0003 0005 0009 0003 0006 0009 0005 0009 0003 
0005 0010 0003 0005 0009 0006 0009 0007 0012 0012 0009 0006 0012 0012 0009 0006 0008 0003 0006 0009 0005 0009 0006 0012 0011 0003 0006 0012 0012 0011 
0006 0009 0005 0014 0010 0007 0010 0005 0012 0012 0010 0005 0014 0010 0006 0013 0012 0009 0007 0010 0006 0010 0007 0008 0003 0005 0009 0006 0010 0003 
0005 0012 0010 0003 0003 0003 0005 0010 0004 0012 0013 0010 0003 0003 0003 0004 0012 0014 0009 0003 0003 0003 0003 0006 0013 0010 0006 0009 0005 0009 
0006 0008 0003 0003 0003 0007 0008 0005 0012 0010 0002 0003 0001 0003 0003 0006 0010 0005 0008 0003 0003 0005 0009 0005 0010 0003 0005 0012 0012 0010 
0007 0010 0005 0009 0003 0003 0006 0012 0012 0009 0003 0005 0012 0009 0003 0003 0005 0012 0012 0009 0003 0006 0014 0010 0003 0005 0012 0012 0010 0003 
0003 0005 0012 0010 0003 0003 0003 0004 0012 0014 0015 0012 0008 0006 0009 0005 0012 0010 0006 0012 0009 0003 0003 0003 0005 0010 0004 0012 0011 0003 
0003 0006 0010 0005 0009 0001 0003 0006 0010 0003 0003 0006 0012 0009 0006 0014 0012 0009 0003 0006 0008 0003 0003 0003 0002 0005 0012 0010 0001 0003 
0005 0009 0003 0006 0012 0012 0009 0003 0005 0009 0003 0005 0010 0004 0009 0007 0010 0002 0003 0007 0012 0009 0003 0005 0013 0010 0002 0005 0012 0009 
0006 0008 0005 0009 0006 0014 0010 0003 0006 0010 0005 0010 0003 0006 0010 0001 0003 0003 0003 0003 0006 0008 0003 0004 0012 0013 0013 0012 0010 0002 
0003 0006 0012 0012 0009 0003 0005 0011 0003 0005 0010 0001 0005 0009 0005 0012 0009 0007 0009 0003 0007 0010 0005 0012 0010 0002 0006 0012 0009 0003 
0007 0009 0004 0010 0006 0009 0006 0009 0003 0002 0005 0010 0006 0012 0014 0012 0010 0005 0010 0003 0001 0007 0012 0010 0003 0005 0013 0012 0012 0011 
0003 0006 0012 0009 0003 0004 0009 0006 0009 0007 0008 0005 0009 0006 0009 0002 0003 0006 0009 0005 0012 0009 0002 0003 0005 0010 0004 0012 0014 0009 
0003 0005 0014 0010 0005 0012 0010 0003 0006 0009 0006 0014 0010 0005 0010 0005 0009 0003 0006 0014 0012 0014 0009 0003 0002 0005 0012 0010 0005 0008 
0005 0010 0001 0007 0010 0006 0009 0003 0007 0012 0009 0003 0003 0002 0005 0012 0012 0009 0001 0003 0006 0009 0006 0009 0005 0014 0010 0005 0012 0010 
0002 0005 0012 0009 0003 0005 0012 0009 0003 0006 0010 0003 0005 0011 0004 0014 0010 0006 0010 0003 0005 0010 0005 0012 0010 0003 0003 0006 0010 0003 
0003 0006 0012 0010 0005 0010 0004 0012 0013 0009 0001 0005 0010 0005 0012 0009 0005 0009 0003 0003 0006 0009 0006 0008 0003 0003 0003 0001 0003 0003 
0003 0003 0002 0005 0010 0005 0010 0006 0012 0012 0012 0012 0009 0006 0012 0012 0012 0008 0003 0003 0005 0012 0009 0006 0009 0003 0003 0006 0009 0003 
0007 0009 0007 0010 0005 0010 0003 0003 0004 0012 0014 0012 0008 0007 0010 0006 0012 0012 0009 0005 0012 0012 0012 0013 0012 0009 0003 0003 0006 0011 
0003 0006 0009 0003 0006 0009 0003 0005 0010 0006 0009 0006 0010 0003 0003 0003 0004 0012 0014 0010 0006 0012 0012 0012 0012 0010 0005 0009 0003 0003 
0005 0009 0004 0009 0005 0012 0013 0012 0009 0005 0012 0009 0005 0009 0005 0013 0012 0012 0009 0005 0009 0004 0012 0012 0012 0013 0012 0012 0009 0001 

0001 0006 0007 0008 1184 1177 0239 0240 0241 0242 0293 0294 0295 0301 0302 0305 0306 0307 0308 1105 1010 1011 1012 1103 1102 1101 1035 1036 1100 1099 
0002 0005 0014 0009 1183 1178 0238 0245 0244 0243 0292 0299 0296 0300 0303 0304 0313 0314 0309 1106 1009 1008 1013 1014 1032 1033 1034 1037 1038 1039 
0003 0004 0013 0010 1182 1179 0237 0246 0251 0252 0291 0290 0297 0274 0273 0317 0312 0311 0310 1005 1006 1007 1016 1015 1031 1071 1070 1048 1047 1040 
0016 0015 0012 0011 1181 1180 0236 0247 0250 0253 0288 0289 0298 0275 0272 0316 0315 1108 1107 1004 1021 1018 1017 1029 1030 1068 1069 1049 1046 1041 
0017 0020 0021 0232 0233 0234 0235 0248 0249 0254 0287 0280 0279 0276 0271 0318 0319 1109 1159 1003 1020 1019 1104 1028 1066 1067 1051 1050 1045 1042 
0018 0019 0022 0203 0202 0201 0200 0199 0256 0255 0282 0281 0278 0277 0270 0321 0320 1110 1001 1002 1022 1025 1026 1027 1060 1059 1052 1053 1044 1043 
0033 0034 0023 0204 0227 0228 0231 0198 0257 0258 0283 0284 0285 0286 0269 0322 0323 1111 1000 0999 1023 1024 1065 1062 1061 1058 1072 1054 1082 1083 
0032 0031 0024 0205 0206 0229 0230 0197 0260 0259 0264 0265 0266 0267 0268 0343 0324 1112 1113 0998 0997 0996 0995 1063 1064 1057 1056 1055 1081 1080 
0035 0030 0025 0226 0207 0194 0195 0196 0261 0262 0263 1176 0344 0340 0341 0342 0325 0326 1114 1121 1120 1119 0994 0991 0990 1073 1074 1075 1078 1079 
0036 0029 0026 0225 0208 0193 1175 1174 0349 0348 0347 0346 0345 0339 0336 0335 0334 0327 1115 1116 1117 1118 0993 0992 0989 0986 0985 1076 1077 1084 
0037 0028 0027 0210 0209 0192 0189 0188 0350 1172 1171 0359 0360 0338 0337 1170 0333 0328 0329 1126 1125 1122 1135 1134 0988 0987 0984 1089 1090 1085 
0038 0213 0212 0211 0222 0191 0190 0187 0351 0356 0357 0358 0361 0370 0369 0373 0332 0331 0330 1127 1124 1123 1136 1133 1137 1138 0983 1088 1087 1086 
0039 0214 0217 0218 0221 0223 0185 0186 0352 0355 0412 0413 0362 0371 0368 0374 0379 0378 0380 1128 1129 1130 1131 1132 1148 1139 0982 0981 1091 1096 
0040 0215 0216 0219 0220 0224 0184 1173 0353 0354 0411 0414 0363 0372 0367 0375 0376 0377 0381 0485 0486 0487 0488 0489 1147 1140 1152 0980 1092 1095 
0041 0042 0043 0044 0045 0046 0183 0182 0407 0408 0403 0402 0364 0365 0366 0417 0386 0385 0382 0484 0501 0500 0499 0490 1146 1141 1151 0979 1093 1094 
0054 0053 0052 0051 0048 0047 1185 0181 0406 0405 0404 0401 0398 0397 0415 0416 0387 0384 0383 0483 0482 0497 0498 0491 1145 1142 1150 0978 0977 1097 
0055 0056 0057 0050 0049 1187 1186 0180 0179 0409 0410 0400 0399 0395 0394 0418 0388 1165 1160 0480 0481 0496 0493 0492 1144 1143 1149 1153 0976 1098 
0072 0073 0058 0059 0060 1188 1189 1190 0178 0177 0176 0175 0174 0396 0393 0419 0389 1164 1161 0479 0502 0495 0494 0513 0514 0515 0516 1154 0975 0974 
0071 0068 0067 0066 0061 0138 0139 0140 0141 1191 1192 1193 0173 0172 0392 0391 0390 1163 1162 0478 0503 0508 0509 0512 0567 0568 0517 1155 1158 0973 
0070 0069 0089 0065 0062 0137 0136 1198 0142 0143 0144 1194 1195 0171 0170 0420 0421 0422 1166 0477 0504 0507 0510 0511 0566 0519 0518 1156 1157 0972 
0074 0075 0088 0064 0063 0134 0135 0148 0147 0146 0145 0166 0167 0168 0169 1168 1169 0423 0475 0476 0505 0506 0570 0569 0565 0520 0523 0524 0525 0526 
0077 0076 0087 0086 0090 0127 0126 0149 0150 0151 0152 0165 0164 0163 0427 0426 0425 0424 0468 0467 0577 0576 0571 0971 0564 0521 0522 0531 0530 0527 
0078 0079 0080 0085 0091 0128 0125 0124 0155 0154 0153 0156 1196 0162 0428 0474 0473 0470 0469 0466 0578 0575 0572 0552 0553 0554 0533 0532 0529 0528 
1199 1200 0081 0084 0092 0129 0130 0123 0122 0121 0655 0157 1197 0161 0429 0459 0460 0471 0472 0465 0579 0574 0573 0551 0550 0555 0534 0535 0536 0537 
0101 0100 0082 0083 0093 0131 0117 0118 0119 0120 0654 0158 0159 0160 0430 0458 0461 0462 0463 0464 0580 0848 0816 0817 0549 0556 0557 0558 0559 0538 
0102 0099 0098 0097 0094 0132 0116 0664 0663 0652 0653 0656 0657 0432 0431 0457 0456 0455 0583 0582 0581 0849 0815 0818 0548 0547 0562 0561 0560 0539 
0103 0106 0107 0096 0095 0133 0115 0647 0648 0651 0658 0435 0434 0433 0450 0449 0453 0454 0584 0927 0928 0850 0814 0819 0847 0546 0545 0544 0563 0540 
0104 0105 0108 0111 0112 0113 0114 0646 0649 0650 0659 0436 0437 0452 0451 0448 0447 0970 0585 0853 0852 0851 0813 0820 0821 0822 0827 0543 0542 0541 
0673 0674 0109 0110 0665 0637 0638 0645 0618 0617 0660 0661 0438 0441 0442 1167 0446 0969 0586 0854 0925 0926 0812 0825 0824 0823 0826 0828 0829 0844 
0672 0669 0668 0667 0666 0636 0639 0640 0619 0616 0615 0662 0439 0440 0443 0444 0445 0588 0587 0855 0923 0922 0811 0810 0809 0846 0832 0831 0830 0843 
0671 0670 0967 0966 0634 0635 0642 0641 0620 0715 0614 0613 0610 0609 0602 0603 0604 0589 0590 0856 0924 0860 0861 0862 0808 0845 0833 0834 0835 0836 
0675 0963 0964 0965 0633 0644 0643 0622 0621 0714 0716 0612 0611 0600 0601 0608 0605 0592 0591 0857 0858 0859 0899 0863 0807 0806 0842 0841 0838 0837 
0676 0962 0961 0960 0632 0631 0630 0623 0712 0713 0708 0707 0725 0599 0598 0607 0606 0593 0883 0882 0885 0886 0898 0864 0907 0805 0804 0803 0839 0840 
0677 0678 0968 0682 0683 0628 0629 0624 0711 0710 0709 0706 0726 0729 0597 0596 0595 0594 0884 0881 0888 0887 0866 0865 0906 0905 0908 0802 0801 0800 
0959 0679 0680 0681 0684 0627 0626 0625 0717 0720 0721 0705 0727 0728 0931 0733 0734 0737 0738 0880 0889 0890 0867 0868 0869 0904 0909 0920 0919 0799 
0958 0942 0941 0940 0685 0686 0724 0723 0718 0719 0722 0704 0703 0730 0731 0732 0735 0736 0739 0879 0892 0891 0896 0897 0870 0903 0910 0921 0918 0798 
0957 0943 0952 0939 0938 0687 0688 0697 0698 0699 0700 0701 0702 0751 0752 0753 0754 0755 0740 0878 0893 0894 0895 0872 0871 0902 0911 0916 0917 0797 
0945 0944 0951 0953 0937 0936 0689 0696 0770 0769 0766 0767 0768 0750 0749 0744 0743 0742 0741 0877 0876 0875 0874 0873 0900 0901 0912 0915 0795 0796 
0946 0949 0950 0954 0934 0935 0690 0695 0694 0764 0765 0760 0759 0756 0748 0745 0776 0775 0774 0777 0780 0781 0782 0783 0784 0785 0913 0914 0794 0929 
0947 0948 0956 0955 0933 0932 0691 0692 0693 0763 0762 0761 0758 0757 0747 0746 0771 0772 0773 0778 0779 0790 0789 0788 0787 0786 0791 0792 0793 0930 
