10 10
002 004 014 012 010 004 012 014 010 002 
005 010 003 006 009 006 012 009 005 011 
002 005 009 003 006 013 010 004 012 009 
003 006 012 009 003 002 005 012 012 010 
007 009 006 012 013 009 006 012 012 011 
003 006 009 006 012 012 009 002 006 009 
003 005 008 003 002 006 010 007 009 002 
003 006 012 009 003 003 005 009 004 011 
003 003 006 010 007 009 004 012 014 011 
005 009 001 005 013 012 012 012 009 001 

001 008 007 009 010 058 057 049 050 053 
002 003 006 012 011 046 047 048 051 052 
020 004 005 013 059 045 044 056 055 054 
019 016 015 014 060 063 043 042 041 040 
018 017 065 064 061 062 036 037 038 039 
021 067 066 032 033 034 035 100 071 070 
022 068 069 031 082 077 076 073 072 097 
023 028 029 030 081 078 075 074 096 095 
024 027 086 085 080 079 099 098 092 093 
025 026 087 084 083 088 089 090 091 094 
