25 40
0002 0006 0010 0006 0014 0012 0010 0006 0012 0012 0012 0014 0010 0006 0012 0012 0012 0012 0008 0006 0012 0014 0014 0012 0008 
0003 0001 0005 0009 0003 0002 0003 0003 0006 0012 0010 0003 0003 0003 0006 0012 0012 0010 0006 0009 0006 0009 0001 0006 0010 
0005 0012 0012 0012 0009 0007 0009 0005 0009 0002 0003 0003 0003 0003 0003 0006 0010 0005 0009 0002 0005 0012 0012 0009 0003 
0006 0012 0012 0012 0010 0005 0010 0006 0012 0013 0009 0003 0003 0003 0003 0003 0003 0006 0012 0013 0012 0012 0010 0006 0011 
0007 0010 0006 0008 0005 0010 0003 0005 0012 0010 0006 0009 0003 0003 0003 0003 0005 0009 0006 0012 0012 0014 0009 0003 0003 
0003 0003 0005 0014 0010 0003 0005 0012 0010 0003 0003 0002 0003 0003 0003 0003 0006 0012 0009 0006 0010 0003 0006 0009 0003 
0003 0005 0010 0003 0003 0005 0010 0006 0009 0003 0003 0005 0011 0003 0003 0001 0005 0010 0006 0009 0003 0003 0003 0004 0009 
0003 0006 0009 0001 0003 0006 0009 0005 0010 0001 0005 0010 0003 0007 0009 0006 0010 0003 0003 0006 0009 0003 0005 0012 0010 
0003 0005 0012 0010 0003 0005 0010 0002 0005 0012 0012 0009 0003 0003 0004 0011 0003 0003 0003 0005 0008 0005 0010 0006 0009 
0005 0012 0010 0003 0003 0006 0013 0013 0012 0012 0014 0008 0003 0003 0006 0009 0003 0003 0003 0006 0012 0012 0009 0005 0010 
0006 0010 0003 0003 0003 0007 0008 0006 0010 0004 0009 0006 0009 0005 0009 0006 0009 0003 0003 0003 0006 0010 0004 0010 0003 
0003 0003 0003 0003 0003 0003 0006 0009 0005 0012 0012 0009 0006 0012 0010 0005 0012 0009 0003 0005 0009 0005 0012 0011 0003 
0003 0001 0003 0003 0007 0009 0003 0006 0010 0006 0012 0014 0009 0002 0003 0006 0012 0010 0007 0012 0012 0008 0006 0009 0003 
0007 0010 0003 0003 0003 0002 0003 0001 0005 0009 0006 0009 0006 0011 0005 0009 0002 0003 0003 0006 0012 0012 0009 0006 0011 
0001 0005 0011 0003 0005 0011 0005 0012 0012 0012 0009 0006 0011 0005 0010 0002 0007 0009 0003 0003 0002 0006 0012 0009 0003 
0006 0010 0001 0005 0010 0005 0012 0014 0008 0006 0012 0009 0005 0010 0005 0011 0003 0006 0013 0013 0009 0005 0014 0010 0003 
0003 0005 0010 0006 0011 0006 0010 0001 0006 0009 0004 0012 0010 0003 0004 0011 0003 0003 0004 0010 0006 0010 0003 0003 0001 
0007 0010 0005 0009 0003 0003 0005 0012 0009 0004 0014 0010 0003 0005 0010 0001 0003 0005 0010 0003 0003 0003 0003 0005 0010 
0003 0005 0012 0010 0003 0003 0006 0010 0006 0012 0009 0005 0013 0010 0005 0010 0003 0004 0013 0009 0003 0003 0005 0008 0003 
0003 0006 0012 0009 0003 0005 0009 0003 0005 0010 0006 0012 0010 0005 0008 0005 0009 0006 0010 0006 0009 0005 0012 0010 0003 
0001 0003 0004 0012 0011 0006 0010 0003 0006 0011 0003 0002 0005 0012 0012 0014 0012 0009 0003 0003 0006 0012 0010 0003 0003 
0006 0009 0006 0010 0003 0003 0001 0003 0003 0003 0005 0011 0006 0010 0002 0005 0010 0002 0003 0003 0003 0002 0005 0009 0003 
0007 0012 0009 0003 0005 0009 0006 0009 0003 0003 0006 0009 0003 0005 0013 0008 0003 0007 0009 0003 0003 0007 0010 0004 0011 
0001 0006 0012 0011 0006 0012 0009 0006 0011 0001 0007 0012 0009 0006 0012 0012 0009 0003 0006 0009 0003 0003 0005 0012 0011 
0006 0009 0006 0009 0003 0006 0010 0003 0003 0006 0009 0006 0012 0009 0004 0012 0010 0003 0003 0006 0009 0003 0006 0008 0003 
0005 0010 0003 0002 0005 0009 0003 0003 0005 0009 0006 0009 0006 0012 0012 0012 0011 0005 0009 0005 0012 0009 0007 0010 0003 
0006 0009 0005 0011 0004 0010 0003 0003 0006 0012 0009 0004 0011 0002 0006 0012 0009 0004 0010 0006 0012 0012 0009 0005 0009 
0007 0010 0004 0013 0012 0009 0003 0003 0005 0012 0010 0006 0011 0005 0013 0012 0012 0012 0011 0003 0006 0012 0012 0012 0010 
0003 0005 0012 0012 0012 0010 0003 0003 0006 0012 0009 0003 0003 0006 0012 0012 0012 0010 0003 0003 0005 0010 0006 0012 0011 
0003 0006 0012 0012 0010 0005 0009 0001 0005 0012 0010 0003 0001 0003 0002 0006 0010 0003 0001 0003 0002 0003 0005 0010 0001 
0003 0003 0006 0010 0003 0004 0012 0014 0012 0012 0009 0007 0012 0009 0005 0009 0003 0003 0006 0009 0007 0013 0008 0005 0010 
0005 0009 0003 0003 0005 0012 0012 0009 0002 0006 0010 0003 0004 0014 0012 0012 0011 0005 0009 0006 0009 0002 0006 0012 0011 
0006 0012 0009 0007 0012 0012 0014 0008 0007 0009 0003 0003 0006 0009 0002 0006 0009 0004 0012 0013 0010 0003 0003 0004 0011 
0005 0010 0002 0005 0010 0004 0011 0006 0009 0006 0011 0005 0009 0006 0011 0003 0006 0014 0012 0010 0005 0011 0005 0010 0003 
0006 0009 0007 0010 0005 0010 0003 0003 0002 0003 0003 0004 0010 0003 0005 0009 0001 0003 0006 0009 0006 0013 0008 0003 0003 
0003 0006 0009 0007 0010 0003 0001 0003 0003 0003 0005 0014 0009 0003 0006 0012 0012 0009 0003 0002 0003 0006 0010 0003 0003 
0003 0001 0006 0009 0003 0005 0012 0009 0003 0005 0010 0003 0006 0009 0005 0010 0002 0006 0009 0007 0009 0003 0005 0009 0003 
0005 0012 0009 0002 0003 0006 0010 0006 0013 0010 0003 0001 0003 0006 0012 0009 0003 0003 0004 0009 0006 0009 0006 0008 0003 
0006 0014 0012 0009 0003 0003 0003 0005 0008 0003 0005 0012 0009 0003 0002 0006 0013 0009 0006 0010 0003 0002 0007 0010 0003 
0001 0005 0012 0012 0013 0009 0005 0012 0012 0013 0012 0012 0012 0009 0005 0013 0012 0012 0009 0005 0009 0005 0009 0005 0009 

0001 0014 0013 0010 0009 0016 0017 0981 0980 0979 0978 0044 0045 0316 0317 0318 0319 0320 0321 0294 0293 0288 0289 0291 0292 
0002 0015 0012 0011 0008 1000 0018 0982 0985 0986 0987 0043 0046 0315 0302 0301 0300 0299 0296 0295 0286 0287 0290 0281 0280 
0003 0004 0005 0006 0007 0020 0019 0983 0984 0999 0988 0042 0047 0314 0303 0362 0361 0298 0297 0367 0285 0284 0283 0282 0279 
0887 0888 0889 0890 0891 0021 0022 0992 0991 0990 0989 0041 0048 0313 0304 0363 0360 0357 0356 0355 0354 0353 0352 0277 0278 
0886 0885 0925 0926 0892 0893 0023 0993 0994 0995 0039 0040 0049 0312 0305 0364 0359 0358 0347 0348 0349 0350 0351 0276 0429 
0938 0884 0924 0923 0922 0894 0024 0025 0026 0996 0038 0977 0050 0311 0306 0365 0344 0345 0346 0406 0407 0368 0274 0275 0430 
0939 0883 0882 0927 0921 0895 0896 0028 0027 0997 0037 0976 0051 0310 0307 0366 0343 0342 0404 0405 0408 0369 0273 0432 0431 
0940 0880 0881 0928 0920 0898 0897 0029 0030 0998 0036 0035 0052 0309 0308 0329 0330 0341 0403 0410 0409 0370 0272 0271 0270 
0941 0879 0878 0877 0919 0899 0900 0931 0031 0032 0033 0034 0053 0322 0428 0328 0331 0340 0402 0411 0412 0371 0372 0268 0269 
0942 0943 0944 0876 0918 0902 0901 0930 0932 0933 0934 0935 0054 0323 0326 0327 0332 0339 0401 0376 0375 0374 0373 0267 0266 
0956 0957 0945 0875 0917 0903 0929 0062 0061 0937 0936 0056 0055 0324 0325 0334 0333 0338 0400 0377 0380 0381 0427 0426 0265 
0955 0958 0946 0874 0916 0904 0064 0063 0060 0059 0058 0057 0083 0084 0085 0335 0336 0337 0399 0378 0379 0382 0383 0384 0264 
0954 0959 0947 0873 0906 0905 0065 0080 0079 0076 0075 0074 0082 0974 0086 0089 0090 0091 0398 0413 0414 0415 0386 0385 0263 
0953 0952 0948 0872 0907 0915 0066 0081 0078 0077 0072 0073 0964 0965 0087 0088 0975 0092 0397 0390 0389 0388 0387 0261 0262 
0960 0951 0949 0871 0908 0909 0067 0068 0069 0070 0071 0109 0108 0966 0967 0970 0094 0093 0396 0391 0394 0258 0259 0260 0433 
0848 0849 0950 0870 0869 0910 0911 0912 0914 0112 0111 0110 0107 0106 0968 0969 0095 0416 0395 0392 0393 0257 0256 0255 0434 
0847 0850 0851 0854 0855 0119 0118 0913 0114 0113 0783 0782 0781 0105 0972 0971 0096 0417 0425 0424 0218 0219 0436 0254 0435 
0846 0845 0852 0853 0856 0120 0117 0116 0115 0776 0775 0777 0780 0104 0103 0973 0097 0418 0419 0423 0217 0220 0437 0253 0252 
0961 0844 0843 0842 0857 0121 0124 0125 0772 0773 0774 0778 0779 0784 0102 0101 0098 0421 0420 0422 0216 0221 0438 0439 0251 
0962 0839 0840 0841 0858 0122 0123 0126 0771 0770 0752 0751 0750 0785 0786 0100 0099 0198 0199 0214 0215 0222 0223 0224 0250 
0963 0838 0868 0867 0859 0864 0865 0127 0768 0769 0753 0756 0749 0748 0747 0195 0196 0197 0200 0213 0230 0229 0228 0225 0249 
0836 0837 0831 0830 0860 0863 0866 0128 0767 0787 0754 0755 0800 0801 0804 0194 0193 0746 0201 0212 0231 0242 0227 0226 0248 
0834 0833 0832 0829 0861 0862 0130 0129 0766 0788 0758 0757 0799 0802 0803 0805 0192 0203 0202 0211 0232 0241 0243 0440 0247 
0835 0814 0815 0816 0133 0132 0131 0790 0765 0789 0759 0797 0798 0188 0189 0190 0191 0204 0209 0210 0233 0240 0244 0245 0246 
0812 0813 0818 0817 0134 0137 0138 0791 0764 0761 0760 0185 0186 0187 0726 0725 0724 0205 0208 0235 0234 0239 0744 0745 0441 
0811 0810 0819 0822 0135 0136 0139 0792 0763 0762 0183 0184 0719 0720 0721 0722 0723 0206 0207 0236 0237 0238 0446 0445 0442 
0808 0809 0820 0821 0827 0826 0140 0793 0180 0181 0182 0741 0718 0732 0729 0728 0727 0740 0739 0450 0449 0448 0447 0444 0443 
0151 0150 0828 0823 0824 0825 0141 0794 0179 0178 0177 0716 0717 0731 0730 0733 0734 0735 0736 0451 0634 0633 0632 0631 0630 
0152 0149 0148 0147 0146 0145 0142 0795 0174 0175 0176 0715 0742 0464 0463 0462 0461 0460 0737 0452 0635 0636 0626 0627 0628 
0153 0158 0159 0160 0161 0144 0143 0796 0173 0172 0171 0714 0743 0465 0713 0710 0709 0459 0738 0453 0640 0637 0625 0624 0629 
0154 0157 0523 0522 0162 0807 0806 0167 0168 0169 0170 0468 0467 0466 0712 0711 0708 0458 0455 0454 0639 0638 0660 0623 0622 
0155 0156 0524 0521 0163 0164 0165 0166 0507 0504 0503 0469 0476 0475 0477 0478 0479 0457 0456 0642 0641 0657 0602 0603 0604 
0527 0526 0525 0520 0691 0692 0693 0698 0506 0505 0502 0470 0473 0474 0707 0481 0480 0659 0658 0643 0644 0656 0601 0621 0605 
0528 0529 0690 0519 0518 0697 0694 0509 0508 0500 0501 0471 0472 0486 0485 0482 0665 0569 0570 0571 0645 0646 0600 0599 0606 
0531 0530 0686 0685 0517 0516 0695 0510 0675 0499 0699 0704 0703 0487 0484 0483 0666 0568 0573 0572 0648 0647 0655 0598 0607 
0532 0688 0687 0539 0540 0515 0696 0511 0674 0498 0700 0701 0702 0488 0564 0565 0566 0567 0574 0652 0649 0593 0594 0597 0608 
0533 0689 0537 0538 0541 0514 0513 0512 0673 0497 0496 0705 0490 0489 0563 0562 0664 0576 0575 0651 0650 0592 0595 0596 0609 
0534 0535 0536 0684 0542 0547 0548 0670 0669 0668 0495 0706 0491 0559 0560 0561 0663 0577 0654 0653 0590 0591 0616 0617 0610 
0680 0679 0682 0683 0543 0546 0549 0671 0672 0667 0494 0493 0492 0558 0662 0580 0579 0578 0585 0586 0589 0620 0615 0614 0611 
0681 0678 0677 0676 0544 0545 0550 0551 0552 0553 0554 0555 0556 0557 0661 0581 0582 0583 0584 0587 0588 0619 0618 0613 0612 
