25 30
004 010 006 014 010 004 012 014 012 010 006 008 006 012 010 006 012 014 012 010 004 014 010 006 008 
006 009 001 003 005 012 012 009 002 003 003 006 013 008 005 013 010 003 004 013 012 009 003 007 010 
003 006 012 009 004 014 010 006 011 003 003 003 006 012 012 010 001 005 012 010 006 012 009 003 003 
005 009 006 012 012 009 003 003 003 003 007 009 003 006 012 009 006 012 012 009 005 010 004 009 003 
006 012 013 010 006 010 003 003 005 009 003 006 009 003 002 006 013 010 006 010 004 011 006 012 011 
003 006 010 005 009 003 003 003 006 010 001 005 010 003 005 013 008 005 011 005 010 005 009 006 009 
007 009 005 012 008 003 003 003 003 003 006 012 009 005 012 012 012 010 005 008 003 002 006 009 002 
001 006 012 012 010 003 001 005 009 005 009 006 012 012 012 014 008 005 012 012 009 007 009 006 011 
006 009 004 014 009 007 010 006 014 010 002 003 006 010 002 005 014 010 006 012 012 009 006 009 001 
007 012 010 005 010 001 005 009 003 005 011 003 003 003 007 008 003 001 003 006 010 006 013 012 010 
005 010 005 010 005 012 012 012 009 002 003 005 009 003 005 010 005 012 009 001 005 015 012 008 003 
004 013 008 003 006 010 006 010 006 011 003 006 010 005 012 011 004 014 014 012 010 001 006 012 011 
006 012 012 009 003 005 009 005 009 003 003 003 005 012 010 005 010 001 003 002 003 006 009 006 009 
003 006 012 010 007 012 012 010 004 009 003 007 010 002 003 002 003 006 009 007 009 003 006 009 002 
003 005 010 003 005 010 002 005 012 010 003 001 003 003 005 011 005 009 002 003 006 011 005 012 011 
007 010 003 005 010 005 011 006 008 005 013 012 009 007 012 009 002 006 013 009 001 003 006 012 009 
003 003 005 008 005 012 013 011 006 010 004 014 010 003 006 012 011 005 010 006 012 009 005 010 002 
003 005 012 010 006 010 004 009 003 005 010 001 007 009 005 008 005 010 003 003 006 008 006 009 003 
005 010 002 005 009 005 012 010 003 002 005 010 005 012 012 012 012 011 005 009 007 012 009 006 009 
002 003 007 010 006 012 012 009 003 007 010 003 004 014 014 008 006 009 006 010 003 006 010 005 010 
007 009 003 001 003 006 012 012 009 001 003 005 010 003 005 012 013 012 009 003 003 003 005 012 009 
005 012 011 006 009 005 010 006 012 010 005 010 003 005 012 010 006 010 002 003 003 005 012 012 010 
002 006 009 005 012 012 009 005 010 005 012 011 005 012 010 003 003 003 007 009 005 012 012 012 011 
003 003 006 014 012 010 006 012 009 006 012 009 002 006 009 003 003 003 005 014 012 008 006 012 009 
003 003 003 003 002 005 009 006 012 009 002 006 011 005 010 003 003 005 010 001 006 012 009 006 010 
003 003 001 003 007 012 008 005 010 006 011 003 007 010 003 001 003 006 009 006 009 006 012 011 003 
003 005 012 009 003 006 012 012 009 003 001 003 003 001 005 010 003 003 006 009 006 009 002 003 003 
007 012 010 006 013 009 004 012 012 013 012 011 005 012 010 005 009 003 003 002 007 012 009 003 003 
003 006 009 005 010 004 014 012 012 012 010 001 006 012 011 004 010 005 009 005 009 006 012 009 003 
001 005 012 012 013 012 009 004 012 012 013 012 009 004 013 012 013 012 012 012 012 009 004 012 009 

001 002 013 012 015 022 021 020 023 024 115 116 104 103 102 097 096 095 117 118 124 123 125 145 146 
004 003 014 011 016 017 018 019 750 025 114 107 105 106 101 098 099 094 120 119 121 122 126 141 140 
005 008 009 010 605 604 606 032 031 026 113 108 053 054 055 056 100 093 092 091 129 128 127 142 139 
006 007 600 601 602 603 607 033 030 027 110 109 052 059 058 057 087 088 089 090 130 131 144 143 138 
590 589 588 587 584 583 608 034 029 028 111 050 051 060 086 082 081 080 075 074 749 132 135 136 137 
591 594 595 586 585 582 609 035 040 041 112 049 048 061 085 083 084 079 076 073 072 133 134 148 147 
592 593 596 597 598 581 610 036 039 042 045 046 047 062 063 064 065 066 077 078 071 748 150 149 236 
599 558 559 560 561 580 611 037 038 043 044 169 168 167 166 164 165 067 068 069 070 152 151 233 234 
556 557 564 563 562 578 577 574 573 612 615 170 175 176 186 163 162 746 156 155 154 153 231 232 235 
550 549 548 565 566 579 576 575 572 613 614 171 174 177 184 185 161 747 157 244 243 237 230 229 228 
551 552 547 546 567 568 569 570 571 714 616 172 173 178 183 182 160 159 158 245 242 238 240 241 227 
555 553 554 545 704 705 708 709 712 713 617 629 630 179 180 181 197 196 195 199 200 239 224 225 226 
541 542 543 544 703 706 707 710 711 715 618 628 631 632 633 187 188 198 194 204 201 222 223 247 246 
540 735 734 733 702 701 700 699 717 716 619 626 625 693 634 694 189 192 193 203 202 221 249 248 253 
539 736 737 732 718 719 741 698 697 696 620 627 624 692 635 636 190 191 208 205 744 220 250 251 252 
370 369 738 731 730 720 721 726 727 695 621 622 623 639 638 637 652 209 207 206 745 219 256 255 254 
371 368 739 740 729 728 722 723 337 336 690 689 688 640 654 653 651 210 211 216 217 218 257 258 287 
372 367 366 365 362 361 725 724 338 335 334 691 642 641 655 656 650 649 212 215 742 743 260 259 286 
373 374 385 364 363 360 359 358 339 533 333 332 643 644 645 646 647 648 213 214 263 262 261 284 285 
538 375 382 383 354 355 356 357 340 532 531 331 679 678 676 677 658 657 662 663 264 277 278 283 282 
377 376 381 384 353 344 343 342 341 534 530 330 329 680 675 674 659 660 661 664 265 276 279 280 281 
378 379 380 351 352 345 346 406 407 408 529 528 328 681 682 683 310 309 673 665 266 275 274 273 272 
522 387 386 350 349 348 347 405 404 409 410 411 327 326 325 684 311 308 667 666 267 268 269 270 271 
521 388 535 396 397 398 401 402 403 414 413 412 464 323 324 685 312 307 668 669 670 671 290 289 288 
520 389 536 395 525 399 400 417 416 415 462 449 448 322 321 686 313 306 305 672 293 292 291 492 493 
519 390 537 394 524 526 527 418 419 460 461 450 447 465 320 687 314 303 304 295 294 482 481 480 494 
518 391 392 393 523 423 422 421 420 459 463 451 446 466 319 318 315 302 297 296 484 483 491 479 495 
515 514 513 426 425 424 458 457 456 455 454 452 445 444 443 317 316 301 298 488 485 489 490 478 496 
516 511 512 427 428 507 432 433 434 435 436 453 440 441 442 502 501 300 299 487 486 475 476 477 497 
517 510 509 508 429 430 431 506 505 504 437 438 439 503 467 468 469 470 471 472 473 474 500 499 498 
